MMMMMMMMMMMMMMMMMMMMMMMMM
MC_0000M0000M000M0000000M
M_00M0M0M0M000M00M00M000M
M00M00000000M00000000M00M
M0M0M00000MM0M0M0000M0M0M
M000000M000000000MM00000M
M00M0000000M0M0000000M00M
M000M0M0M000M000M000M000M
M00M0000000M0M0000M00M00M
M0000M0M0M00000M0MMM0000M
M0M000000M0M0M00000000M0M
M00M0000MM00M000M0000M00M
M0M0M0M000M000M0M0M0M0M_M
M000000M0000M0000M0000_BM
MMMMMMMMMMMMMMMMMMMMMMMMM